# Map metadata
width: 100
height: 10
tileSize: 24

# Tiles layer (one line per row)
# Format per tile: tilesheetIndex,id,solid,destructible,restitution,friction
tiles:
0,23,0,0,0,0     0,23,0,0,0,0      0,23,0,0,0,0      0,23,0,0,0,0      0,23,0,0,0,0      0,23,0,0,0,0      0,23,0,0,0,0      0,23,0,0,0,0,0    0,23,0,0,0,0      0,23,0,0,0,0  0,23,0,0,0,0     0,23,0,0,0,0      0,23,0,0,0,0      0,23,0,0,0,0      0,23,0,0,0,0      0,23,0,0,0,0      0,23,0,0,0,0      0,23,0,0,0,0,0    0,23,0,0,0,0     0,23,0,0,0,0  0,23,0,0,0,0  0,23,0,0,0,0      0,23,0,0,0,0      0,23,0,0,0,0      0,23,0,0,0,0      0,23,0,0,0,0      0,23,0,0,0,0      0,23,0,0,0,0,0    0,23,0,0,0,0      0,23,0,0,0,0  0,23,0,0,0,0     0,23,0,0,0,0      0,23,0,0,0,0      0,23,0,0,0,0      0,23,0,0,0,0      0,23,0,0,0,0      0,23,0,0,0,0      0,23,0,0,0,0,0    0,23,0,0,0,0      0,23,0,0,0,0  0,23,0,0,0,0     0,23,0,0,0,0      0,23,0,0,0,0      0,23,0,0,0,0      0,23,0,0,0,0      0,23,0,0,0,0      0,23,0,0,0,0      0,23,0,0,0,0,0    0,23,0,0,0,0      0,23,0,0,0,0  0,23,0,0,0,0     0,23,0,0,0,0      0,23,0,0,0,0      0,23,0,0,0,0      0,23,0,0,0,0      0,23,0,0,0,0      0,23,0,0,0,0      0,23,0,0,0,0,0    0,23,0,0,0,0      0,23,0,0,0,0  0,23,0,0,0,0     0,23,0,0,0,0      0,23,0,0,0,0      0,23,0,0,0,0      0,23,0,0,0,0      0,23,0,0,0,0      0,23,0,0,0,0      0,23,0,0,0,0,0    0,23,0,0,0,0      0,23,0,0,0,0  0,23,0,0,0,0     0,23,0,0,0,0      0,23,0,0,0,0      0,23,0,0,0,0      0,23,0,0,0,0      0,23,0,0,0,0      0,23,0,0,0,0      0,23,0,0,0,0,0    0,23,0,0,0,0      0,23,0,0,0,0  0,23,0,0,0,0     0,23,0,0,0,0      0,23,0,0,0,0      0,23,0,0,0,0      0,23,0,0,0,0      0,23,0,0,0,0      0,23,0,0,0,0      0,23,0,0,0,0,0    0,23,0,0,0,0      0,23,0,0,0,0  0,23,0,0,0,0     0,23,0,0,0,0      0,23,0,0,0,0      0,23,0,0,0,0      0,23,0,0,0,0      0,23,0,0,0,0      0,23,0,0,0,0      0,23,0,0,0,0,0    0,23,0,0,0,0      0,23,0,0,0,0  0,23,0,0,0,0     0,23,0,0,0,0      0,23,0,0,0,0      0,23,0,0,0,0      0,23,0,0,0,0      0,23,0,0,0,0      0,23,0,0,0,0      0,23,0,0,0,0,0    0,23,0,0,0,0      0,23,0,0,0,0  
0,23,0,0,0,0     0,23,0,0,0,0      0,23,0,0,0,0      0,23,0,0,0,0      0,23,0,0,0,0      0,23,0,0,0,0      0,23,0,0,0,0      0,23,0,0,0,0,0    0,23,0,0,0,0      0,23,0,0,0,0  0,23,0,0,0,0     0,23,0,0,0,0      0,23,0,0,0,0      0,23,0,0,0,0      0,23,0,0,0,0      0,23,0,0,0,0      0,23,0,0,0,0      0,23,0,0,0,0,0    0,23,0,0,0,0     0,23,0,0,0,0  0,23,0,0,0,0  0,23,0,0,0,0      0,23,0,0,0,0      0,23,0,0,0,0      0,23,0,0,0,0      0,23,0,0,0,0      0,23,0,0,0,0      0,23,0,0,0,0,0    0,23,0,0,0,0      0,23,0,0,0,0  0,23,0,0,0,0     0,23,0,0,0,0      0,23,0,0,0,0      0,23,0,0,0,0      0,23,0,0,0,0      0,23,0,0,0,0      0,23,0,0,0,0      0,23,0,0,0,0,0    0,23,0,0,0,0      0,23,0,0,0,0  0,23,0,0,0,0     0,23,0,0,0,0      0,23,0,0,0,0      0,23,0,0,0,0      0,23,0,0,0,0      0,23,0,0,0,0      0,23,0,0,0,0      0,23,0,0,0,0,0    0,23,0,0,0,0      0,23,0,0,0,0  0,23,0,0,0,0     0,23,0,0,0,0      0,23,0,0,0,0      0,23,0,0,0,0      0,23,0,0,0,0      0,23,0,0,0,0      0,23,0,0,0,0      0,23,0,0,0,0,0    0,23,0,0,0,0      0,23,0,0,0,0  0,23,0,0,0,0     0,23,0,0,0,0      0,23,0,0,0,0      0,23,0,0,0,0      0,23,0,0,0,0      0,23,0,0,0,0      0,23,0,0,0,0      0,23,0,0,0,0,0    0,23,0,0,0,0      0,23,0,0,0,0  0,23,0,0,0,0     0,23,0,0,0,0      0,23,0,0,0,0      0,23,0,0,0,0      0,23,0,0,0,0      0,23,0,0,0,0      0,23,0,0,0,0      0,23,0,0,0,0,0    0,23,0,0,0,0      0,23,0,0,0,0  0,23,0,0,0,0     0,23,0,0,0,0      0,23,0,0,0,0      0,23,0,0,0,0      0,23,0,0,0,0      0,23,0,0,0,0      0,23,0,0,0,0      0,23,0,0,0,0,0    0,23,0,0,0,0      0,23,0,0,0,0  0,23,0,0,0,0     0,23,0,0,0,0      0,23,0,0,0,0      0,23,0,0,0,0      0,23,0,0,0,0      0,23,0,0,0,0      0,23,0,0,0,0      0,23,0,0,0,0,0    0,23,0,0,0,0      0,23,0,0,0,0  0,23,0,0,0,0     0,23,0,0,0,0      0,23,0,0,0,0      0,23,0,0,0,0      0,23,0,0,0,0      0,23,0,0,0,0      0,23,0,0,0,0      0,23,0,0,0,0,0    0,23,0,0,0,0      0,23,0,0,0,0  
0,1,1,0,0,0      0,23,0,0,0,0      0,23,0,0,0,0      0,23,0,0,0,0      0,23,0,0,0,0      0,23,0,0,0,0      0,23,0,0,0,0      0,23,0,0,0,0      0,23,0,0,0,0      0,23,0,0,0,0  0,23,0,0,0,0     0,23,0,0,0,0      0,23,0,0,0,0      0,23,0,0,0,0      0,23,0,0,0,0      0,23,0,0,0,0      0,23,0,0,0,0      0,23,0,0,0,0      0,23,0,0,0,0     0,23,0,0,0,0  0,23,0,0,0,0  0,23,0,0,0,0      0,23,0,0,0,0      0,23,0,0,0,0      0,23,0,0,0,0      0,23,0,0,0,0      0,23,0,0,0,0      0,23,0,0,0,0      0,23,0,0,0,0     0,23,0,0,0,0      0,23,0,0,0,0       0,23,0,0,0,0      0,23,0,0,0,0      0,23,0,0,0,0      0,23,0,0,0,0      0,23,0,0,0,0      0,23,0,0,0,0      0,23,0,0,0,0      0,23,0,0,0,0      0,23,0,0,0,0 0,23,0,0,0,0      0,23,0,0,0,0      0,23,0,0,0,0      0,23,0,0,0,0      0,23,0,0,0,0      0,23,0,0,0,0      0,23,0,0,0,0      0,23,0,0,0,0      0,23,0,0,0,0      0,23,0,0,0,0      0,23,0,0,0,0        0,23,0,0,0,0      0,23,0,0,0,0      0,23,0,0,0,0      0,23,0,0,0,0      0,23,0,0,0,0      0,23,0,0,0,0      0,23,0,0,0,0      0,23,0,0,0,0      0,1,1,0,0,0 0,1,1,0,0,0      0,23,0,0,0,0      0,23,0,0,0,0      0,23,0,0,0,0      0,23,0,0,0,0      0,23,0,0,0,0      0,23,0,0,0,0      0,23,0,0,0,0      0,23,0,0,0,0      0,1,1,0,0,0 0,1,1,0,0,0      0,23,0,0,0,0      0,23,0,0,0,0      0,23,0,0,0,0      0,23,0,0,0,0      0,23,0,0,0,0      0,23,0,0,0,0      0,23,0,0,0,0      0,23,0,0,0,0      0,1,1,0,0,0 0,1,1,0,0,0      0,23,0,0,0,0      0,23,0,0,0,0      0,23,0,0,0,0      0,23,0,0,0,0      0,23,0,0,0,0      0,23,0,0,0,0      0,23,0,0,0,0      0,23,0,0,0,0      0,1,1,0,0,0 0,1,1,0,0,0      0,23,0,0,0,0      0,23,0,0,0,0      0,23,0,0,0,0      0,23,0,0,0,0      0,23,0,0,0,0      0,23,0,0,0,0      0,23,0,0,0,0      0,23,0,0,0,0      0,1,1,0,0,0 0,1,1,0,0,0      0,23,0,0,0,0      0,23,0,0,0,0      0,23,0,0,0,0      0,23,0,0,0,0      0,23,0,0,0,0      0,23,0,0,0,0      0,23,0,0,0,0      0,23,0,0,0,0      0,1,1,0,0,0 
0,1,1,0,0,0      0,23,0,0,0,0      0,23,0,0,0,0      0,23,0,0,0,0      0,23,0,0,0,0      0,23,0,0,0,0      0,23,0,0,0,0      0,23,0,0,0,0      0,23,0,0,0,0      0,23,0,0,0,0  0,23,0,0,0,0     0,23,0,0,0,0      0,23,0,0,0,0      0,23,0,0,0,0      0,23,0,0,0,0      0,23,0,0,0,0      0,23,0,0,0,0      0,23,0,0,0,0      0,23,0,0,0,0     0,23,0,0,0,0  0,23,0,0,0,0  0,23,0,0,0,0      0,23,0,0,0,0      0,23,0,0,0,0      0,23,0,0,0,0      0,23,0,0,0,0      0,23,0,0,0,0      0,23,0,0,0,0      0,23,0,0,0,0     0,23,0,0,0,0      0,23,0,0,0,0        0,23,0,0,0,0      0,23,0,0,0,0      0,23,0,0,0,0      0,23,0,0,0,0      0,23,0,0,0,0      0,23,0,0,0,0      0,23,0,0,0,0      0,23,0,0,0,0      0,23,0,0,0,0 0,23,0,0,0,0      0,23,0,0,0,0      0,23,0,0,0,0      0,23,0,0,0,0      0,23,0,0,0,0      0,23,0,0,0,0      0,23,0,0,0,0      0,23,0,0,0,0      0,23,0,0,0,0     0,23,0,0,0,0      0,23,0,0,0,0        0,23,0,0,0,0      0,23,0,0,0,0      0,23,0,0,0,0      0,23,0,0,0,0      0,23,0,0,0,0      0,23,0,0,0,0      0,23,0,0,0,0      0,23,0,0,0,0      0,1,1,0,0,0 0,1,1,0,0,0      0,23,0,0,0,0      0,23,0,0,0,0      0,23,0,0,0,0      0,23,0,0,0,0      0,23,0,0,0,0      0,23,0,0,0,0      0,23,0,0,0,0      0,23,0,0,0,0      0,1,1,0,0,0 0,1,1,0,0,0      0,23,0,0,0,0      0,23,0,0,0,0      0,23,0,0,0,0      0,23,0,0,0,0      0,23,0,0,0,0      0,23,0,0,0,0      0,23,0,0,0,0      0,23,0,0,0,0      0,1,1,0,0,0 0,1,1,0,0,0      0,23,0,0,0,0      0,23,0,0,0,0      0,23,0,0,0,0      0,23,0,0,0,0      0,23,0,0,0,0      0,23,0,0,0,0      0,23,0,0,0,0      0,23,0,0,0,0      0,1,1,0,0,0 0,1,1,0,0,0      0,23,0,0,0,0      0,23,0,0,0,0      0,23,0,0,0,0      0,23,0,0,0,0      0,23,0,0,0,0      0,23,0,0,0,0      0,23,0,0,0,0      0,23,0,0,0,0      0,1,1,0,0,0 0,1,1,0,0,0      0,23,0,0,0,0      0,23,0,0,0,0      0,23,0,0,0,0      0,23,0,0,0,0      0,23,0,0,0,0      0,23,0,0,0,0      0,23,0,0,0,0      0,23,0,0,0,0      0,1,1,0,0,0 
0,1,1,0,0,0      0,23,0,0,0,0      0,23,0,0,0,0      0,23,0,0,0,0      0,23,0,0,0,0      0,23,0,0,0,0      0,23,0,0,0,0      0,23,0,0,0,0      0,23,0,0,0,0      0,23,0,0,0,0  0,23,0,0,0,0     0,23,0,0,0,0      0,23,0,0,0,0      0,23,0,0,0,0      0,23,0,0,0,0      0,23,0,0,0,0      0,23,0,0,0,0      0,23,0,0,0,0      0,23,0,0,0,0     0,23,0,0,0,0  0,23,0,0,0,0  0,23,0,0,0,0      0,23,0,0,0,0      0,23,0,0,0,0      0,23,0,0,0,0      0,23,0,0,0,0      0,23,0,0,0,0      0,23,0,0,0,0      0,23,0,0,0,0     0,23,0,0,0,0      0,23,0,0,0,0        0,23,0,0,0,0      0,23,0,0,0,0      0,23,0,0,0,0      0,23,0,0,0,0      0,23,0,0,0,0      0,23,0,0,0,0      0,23,0,0,0,0      0,23,0,0,0,0      0,23,0,0,0,0 0,23,0,0,0,0      0,23,0,0,0,0      0,23,0,0,0,0      0,23,0,0,0,0      0,23,0,0,0,0      0,23,0,0,0,0      0,23,0,0,0,0      0,23,0,0,0,0      0,23,0,0,0,0     0,23,0,0,0,0      0,23,0,0,0,0        0,23,0,0,0,0      0,23,0,0,0,0      0,23,0,0,0,0      0,23,0,0,0,0      0,23,0,0,0,0      0,23,0,0,0,0      0,23,0,0,0,0      0,23,0,0,0,0      0,1,1,0,0,0 0,1,1,0,0,0      0,23,0,0,0,0      0,23,0,0,0,0      0,23,0,0,0,0      0,23,0,0,0,0      0,23,0,0,0,0      0,23,0,0,0,0      0,23,0,0,0,0      0,23,0,0,0,0      0,1,1,0,0,0 0,1,1,0,0,0      0,23,0,0,0,0      0,23,0,0,0,0      0,23,0,0,0,0      0,23,0,0,0,0      0,23,0,0,0,0      0,23,0,0,0,0      0,23,0,0,0,0      0,23,0,0,0,0      0,1,1,0,0,0 0,1,1,0,0,0      0,23,0,0,0,0      0,23,0,0,0,0      0,23,0,0,0,0      0,23,0,0,0,0      0,23,0,0,0,0      0,23,0,0,0,0      0,23,0,0,0,0      0,23,0,0,0,0      0,1,1,0,0,0 0,1,1,0,0,0      0,23,0,0,0,0      0,23,0,0,0,0      0,23,0,0,0,0      0,23,0,0,0,0      0,23,0,0,0,0      0,23,0,0,0,0      0,23,0,0,0,0      0,23,0,0,0,0      0,1,1,0,0,0 0,1,1,0,0,0      0,23,0,0,0,0      0,23,0,0,0,0      0,23,0,0,0,0      0,23,0,0,0,0      0,23,0,0,0,0      0,23,0,0,0,0      0,23,0,0,0,0      0,23,0,0,0,0      0,1,1,0,0,0 
0,1,1,0,0,0      0,23,0,0,0,0      0,23,0,0,0,0      0,23,0,0,0,0      0,23,0,0,0,0      0,23,0,0,0,0      0,23,0,0,0,0      0,23,0,0,0,0      0,23,0,0,0,0      0,23,0,0,0,0  0,23,0,0,0,0     0,23,0,0,0,0      0,23,0,0,0,0      0,23,0,0,0,0      0,23,0,0,0,0      0,23,0,0,0,0      0,23,0,0,0,0      0,23,0,0,0,0      0,23,0,0,0,0     0,23,0,0,0,0  0,23,0,0,0,0  0,23,0,0,0,0      0,23,0,0,0,0      0,23,0,0,0,0      0,23,0,0,0,0      0,23,0,0,0,0      0,23,0,0,0,0      0,23,0,0,0,0      0,23,0,0,0,0      0,23,0,0,0,0      0,23,0,0,0,0        0,23,0,0,0,0      0,23,0,0,0,0      0,23,0,0,0,0      0,23,0,0,0,0      0,23,0,0,0,0      0,23,0,0,0,0      0,23,0,0,0,0      0,23,0,0,0,0      0,23,0,0,0,0 0,23,0,0,0,0      0,23,0,0,0,0      0,23,0,0,0,0      0,23,0,0,0,0      0,23,0,0,0,0      0,23,0,0,0,0      0,23,0,0,0,0      0,23,0,0,0,0      0,23,0,0,0,0      0,23,0,0,0,0      0,23,0,0,0,0        0,23,0,0,0,0      0,23,0,0,0,0      0,23,0,0,0,0      0,23,0,0,0,0      0,23,0,0,0,0      0,23,0,0,0,0      0,23,0,0,0,0      0,23,0,0,0,0      0,1,1,0,0,0 0,1,1,0,0,0      0,23,0,0,0,0      0,23,0,0,0,0      0,23,0,0,0,0      0,23,0,0,0,0      0,23,0,0,0,0      0,23,0,0,0,0      0,23,0,0,0,0      0,23,0,0,0,0      0,1,1,0,0,0 0,1,1,0,0,0      0,23,0,0,0,0      0,23,0,0,0,0      0,23,0,0,0,0      0,23,0,0,0,0      0,23,0,0,0,0      0,23,0,0,0,0      0,23,0,0,0,0      0,23,0,0,0,0      0,1,1,0,0,0 0,1,1,0,0,0      0,23,0,0,0,0      0,23,0,0,0,0      0,23,0,0,0,0      0,23,0,0,0,0      0,23,0,0,0,0      0,23,0,0,0,0      0,23,0,0,0,0      0,23,0,0,0,0      0,1,1,0,0,0 0,1,1,0,0,0      0,23,0,0,0,0      0,23,0,0,0,0      0,23,0,0,0,0      0,23,0,0,0,0      0,23,0,0,0,0      0,23,0,0,0,0      0,23,0,0,0,0      0,23,0,0,0,0      0,1,1,0,0,0 0,1,1,0,0,0      0,23,0,0,0,0      0,23,0,0,0,0      0,23,0,0,0,0      0,23,0,0,0,0      0,23,0,0,0,0      0,23,0,0,0,0      0,23,0,0,0,0      0,23,0,0,0,0      0,1,1,0,0,0 
0,1,1,0,0,0      0,23,0,0,0,0      0,23,0,0,0,0      0,23,0,0,0,0      0,23,0,0,0,0      0,23,0,0,0,0      0,23,0,0,0,0      0,23,0,0,0,0      0,23,0,0,0,0      0,23,0,0,0,0  0,23,0,0,0,0     0,23,0,0,0,0      0,23,0,0,0,0      0,23,0,0,0,0      0,23,0,0,0,0      0,23,0,0,0,0      0,23,0,0,0,0      0,23,0,0,0,0      0,23,0,0,0,0     0,23,0,0,0,0  0,23,0,0,0,0  0,23,0,0,0,0      0,23,0,0,0,0      0,23,0,0,0,0      0,23,0,0,0,0      0,23,0,0,0,0      0,23,0,0,0,0      0,23,0,0,0,0      0,23,0,0,0,0      0,23,0,0,0,0      0,23,0,0,0,0        0,23,0,0,0,0      0,23,0,0,0,0      0,23,0,0,0,0      0,23,0,0,0,0      0,23,0,0,0,0      0,23,0,0,0,0      0,23,0,0,0,0      0,23,0,0,0,0      0,23,0,0,0,0 0,23,0,0,0,0      0,23,0,0,0,0      0,23,0,0,0,0      0,23,0,0,0,0      0,23,0,0,0,0      0,23,0,0,0,0      0,23,0,0,0,0      0,23,0,0,0,0      0,23,0,0,0,0     0,23,0,0,0,0      0,23,0,0,0,0        0,23,0,0,0,0      0,23,0,0,0,0      0,23,0,0,0,0      0,23,0,0,0,0      0,23,0,0,0,0      0,23,0,0,0,0      0,23,0,0,0,0      0,23,0,0,0,0      0,1,1,0,0,0 0,1,1,0,0,0      0,23,0,0,0,0      0,23,0,0,0,0      0,23,0,0,0,0      0,23,0,0,0,0      0,23,0,0,0,0      0,23,0,0,0,0      0,23,0,0,0,0      0,23,0,0,0,0      0,1,1,0,0,0 0,1,1,0,0,0      0,23,0,0,0,0      0,23,0,0,0,0      0,23,0,0,0,0      0,23,0,0,0,0      0,23,0,0,0,0      0,23,0,0,0,0      0,23,0,0,0,0      0,23,0,0,0,0      0,1,1,0,0,0 0,1,1,0,0,0      0,23,0,0,0,0      0,23,0,0,0,0      0,23,0,0,0,0      0,23,0,0,0,0      0,23,0,0,0,0      0,23,0,0,0,0      0,23,0,0,0,0      0,23,0,0,0,0      0,1,1,0,0,0 0,1,1,0,0,0      0,23,0,0,0,0      0,23,0,0,0,0      0,23,0,0,0,0      0,23,0,0,0,0      0,23,0,0,0,0      0,23,0,0,0,0      0,23,0,0,0,0      0,23,0,0,0,0      0,1,1,0,0,0 0,1,1,0,0,0      0,23,0,0,0,0      0,23,0,0,0,0      0,23,0,0,0,0      0,23,0,0,0,0      0,23,0,0,0,0      0,23,0,0,0,0      0,23,0,0,0,0      0,23,0,0,0,0      0,1,1,0,0,0 
0,1,1,0,0,0      0,23,0,0,0,0      0,23,0,0,0,0      0,23,0,0,0,0      0,23,0,0,0,0      0,23,0,0,0,0      0,23,0,0,0,0      0,23,0,0,0,0      0,23,0,0,0,0      0,23,0,0,0,0  0,23,0,0,0,0     0,23,0,0,0,0      0,23,0,0,0,0      0,23,0,0,0,0      0,23,0,0,0,0      0,23,0,0,0,0      0,23,0,0,0,0      0,23,0,0,0,0      0,23,0,0,0,0     0,23,0,0,0,0  0,23,0,0,0,0  0,23,0,0,0,0      0,23,0,0,0,0      0,23,0,0,0,0      0,23,0,0,0,0      0,23,0,0,0,0      0,23,0,0,0,0      0,23,0,0,0,0      0,23,0,0,0,0     0,23,0,0,0,0      0,23,0,0,0,0        0,23,0,0,0,0      0,23,0,0,0,0      0,23,0,0,0,0      0,23,0,0,0,0      0,23,0,0,0,0      0,23,0,0,0,0      0,23,0,0,0,0      0,23,0,0,0,0      0,23,0,0,0,0 0,23,0,0,0,0      0,23,0,0,0,0      0,23,0,0,0,0      0,23,0,0,0,0      0,23,0,0,0,0      0,23,0,0,0,0      0,23,0,0,0,0      0,23,0,0,0,0      0,23,0,0,0,0      0,23,0,0,0,0      0,23,0,0,0,0        0,23,0,0,0,0      0,23,0,0,0,0      0,23,0,0,0,0      0,23,0,0,0,0      0,23,0,0,0,0      0,23,0,0,0,0      0,23,0,0,0,0      0,23,0,0,0,0      0,1,1,0,0,0 0,1,1,0,0,0      0,23,0,0,0,0      0,23,0,0,0,0      0,23,0,0,0,0      0,23,0,0,0,0      0,23,0,0,0,0      0,23,0,0,0,0      0,23,0,0,0,0      0,23,0,0,0,0      0,1,1,0,0,0 0,1,1,0,0,0      0,23,0,0,0,0      0,23,0,0,0,0      0,23,0,0,0,0      0,23,0,0,0,0      0,23,0,0,0,0      0,23,0,0,0,0      0,23,0,0,0,0      0,23,0,0,0,0      0,1,1,0,0,0 0,1,1,0,0,0      0,23,0,0,0,0      0,23,0,0,0,0      0,23,0,0,0,0      0,23,0,0,0,0      0,23,0,0,0,0      0,23,0,0,0,0      0,23,0,0,0,0      0,23,0,0,0,0      0,1,1,0,0,0 0,1,1,0,0,0      0,23,0,0,0,0      0,23,0,0,0,0      0,23,0,0,0,0      0,23,0,0,0,0      0,23,0,0,0,0      0,23,0,0,0,0      0,23,0,0,0,0      0,23,0,0,0,0      0,1,1,0,0,0 0,1,1,0,0,0      0,23,0,0,0,0      0,23,0,0,0,0      0,23,0,0,0,0      0,23,0,0,0,0      0,23,0,0,0,0      0,23,0,0,0,0      0,23,0,0,0,0      0,23,0,0,0,0      0,1,1,0,0,0 
0,1,1,0,0,0      0,23,0,0,0,0      0,23,0,0,0,0      0,23,0,0,0,0      0,23,0,0,0,0      0,23,0,0,0,0      0,23,0,0,0,0      0,23,0,0,0,0      0,23,0,0,0,0      0,23,0,0,0,0  0,23,0,0,0,0     0,23,0,0,0,0      0,23,0,0,0,0      0,23,0,0,0,0      0,23,0,0,0,0      0,23,0,0,0,0      0,23,0,0,0,0      0,23,0,0,0,0      0,23,0,0,0,0     0,23,0,0,0,0  0,23,0,0,0,0  0,23,0,0,0,0      0,23,0,0,0,0      0,23,0,0,0,0      0,23,0,0,0,0      0,23,0,0,0,0      0,23,0,0,0,0      0,23,0,0,0,0      0,23,0,0,0,0     0,23,0,0,0,0      0,23,0,0,0,0        0,23,0,0,0,0      0,23,0,0,0,0      0,23,0,0,0,0      0,23,0,0,0,0      0,23,0,0,0,0      0,23,0,0,0,0      0,23,0,0,0,0      0,23,0,0,0,0      0,23,0,0,0,0 0,23,0,0,0,0      0,23,0,0,0,0      0,23,0,0,0,0      0,23,0,0,0,0      0,23,0,0,0,0      0,23,0,0,0,0      0,23,0,0,0,0      0,23,0,0,0,0      0,23,0,0,0,0     0,23,0,0,0,0      0,23,0,0,0,0        0,23,0,0,0,0      0,23,0,0,0,0      0,23,0,0,0,0      0,23,0,0,0,0      0,23,0,0,0,0      0,23,0,0,0,0      0,23,0,0,0,0      0,23,0,0,0,0      0,1,1,0,0,0 0,1,1,0,0,0      0,23,0,0,0,0      0,23,0,0,0,0      0,23,0,0,0,0      0,23,0,0,0,0      0,23,0,0,0,0      0,23,0,0,0,0      0,23,0,0,0,0      0,23,0,0,0,0      0,1,1,0,0,0 0,1,1,0,0,0      0,23,0,0,0,0      0,23,0,0,0,0      0,23,0,0,0,0      0,23,0,0,0,0      0,23,0,0,0,0      0,23,0,0,0,0      0,23,0,0,0,0      0,23,0,0,0,0      0,1,1,0,0,0 0,1,1,0,0,0      0,23,0,0,0,0      0,23,0,0,0,0      0,23,0,0,0,0      0,23,0,0,0,0      0,23,0,0,0,0      0,23,0,0,0,0      0,23,0,0,0,0      0,23,0,0,0,0      0,1,1,0,0,0 0,1,1,0,0,0      0,23,0,0,0,0      0,23,0,0,0,0      0,23,0,0,0,0      0,23,0,0,0,0      0,23,0,0,0,0      0,23,0,0,0,0      0,23,0,0,0,0      0,23,0,0,0,0      0,1,1,0,0,0 0,1,1,0,0,0      0,23,0,0,0,0      0,23,0,0,0,0      0,23,0,0,0,0      0,23,0,0,0,0      0,23,0,0,0,0      0,23,0,0,0,0      0,23,0,0,0,0      0,23,0,0,0,0      0,1,1,0,0,0 
0,1,1,0,0.2,0.9 0,1,1,0,0.2,0.9 0,1,1,0,0.2,0.9 0,1,1,0,0.2,0.9 0,1,1,0,0.2,0.9 0,4,1,0,0.2,0.25 0,4,1,0,0.2,0.25 0,4,1,0,0.2,0.25 0,4,1,0,0.2,0.25 0,4,1,0,0.2,0.25 0,1,1,0,0.2,0.9 0,1,1,0,0.2,0.9 0,1,1,0,0.2,0.9 0,1,1,0,0.2,0.9 0,1,1,0,0.2,0.9 0,4,1,0,0.2,0.25 0,4,1,0,0.2,0.25 0,4,1,0,0.2,0.25 0,4,1,0,0.2,0.25 0,4,1,0,0.2,0.25 0,1,1,0,0.2,0.9 0,1,1,0,0.2,0.9 0,1,1,0,0.2,0.9 0,1,1,0,0.2,0.9 0,1,1,0,0.2,0.9 0,4,1,0,0.2,0.25 0,4,1,0,0.2,0.25 0,4,1,0,0.2,0.25 0,4,1,0,0.2,0.25 0,4,1,0,0.2,0.250,1,1,0,0.2,0.9 0,1,1,0,0.2,0.9 0,1,1,0,0.2,0.9 0,1,1,0,0.2,0.9 0,1,1,0,0.2,0.9 0,4,1,0,0.2,0.25 0,4,1,0,0.2,0.25 0,4,1,0,0.2,0.25 0,4,1,0,0.2,0.25 0,4,1,0,0.2,0.250,1,1,0,0.2,0.9 0,1,1,0,0.2,0.9 0,1,1,0,0.2,0.9 0,1,1,0,0.2,0.9 0,1,1,0,0.2,0.9 0,4,1,0,0.2,0.25 0,4,1,0,0.2,0.25 0,4,1,0,0.2,0.25 0,4,1,0,0.2,0.25 0,4,1,0,0.2,0.250,1,1,0,0.2,0.9 0,1,1,0,0.2,0.9 0,1,1,0,0.2,0.9 0,1,1,0,0.2,0.9 0,1,1,0,0.2,0.9 0,4,1,0,0.2,0.25 0,4,1,0,0.2,0.25 0,4,1,0,0.2,0.25 0,4,1,0,0.2,0.25 0,4,1,0,0.2,0.250,1,1,0,0.2,0.9 0,1,1,0,0.2,0.9 0,1,1,0,0.2,0.9 0,1,1,0,0.2,0.9 0,1,1,0,0.2,0.9 0,4,1,0,0.2,0.25 0,4,1,0,0.2,0.25 0,4,1,0,0.2,0.25 0,4,1,0,0.2,0.25 0,4,1,0,0.2,0.250,1,1,0,0.2,0.9 0,1,1,0,0.2,0.9 0,1,1,0,0.2,0.9 0,1,1,0,0.2,0.9 0,1,1,0,0.2,0.9 0,4,1,0,0.2,0.25 0,4,1,0,0.2,0.25 0,4,1,0,0.2,0.25 0,4,1,0,0.2,0.25 0,4,1,0,0.2,0.250,1,1,0,0.2,0.9 0,1,1,0,0.2,0.9 0,1,1,0,0.2,0.9 0,1,1,0,0.2,0.9 0,1,1,0,0.2,0.9 0,4,1,0,0.2,0.25 0,4,1,0,0.2,0.25 0,4,1,0,0.2,0.25 0,4,1,0,0.2,0.25 0,4,1,0,0.2,0.250,1,1,0,0.2,0.9 0,1,1,0,0.2,0.9 0,1,1,0,0.2,0.9 0,1,1,0,0.2,0.9 0,1,1,0,0.2,0.9 0,4,1,0,0.2,0.25 0,4,1,0,0.2,0.25 0,4,1,0,0.2,0.25 0,4,1,0,0.2,0.25 0,4,1,0,0.2,0.25
